10 10
W W W W W W W W W W
W G G G G G G G G W
W G G G G G W G G W
W G G G W G W W G W
W G G G W G G W W W
W G G G W G G G G W
W W W W W G G G G W
W G G G W G G G G W
W G G G G G G G G W
W W W W W W W W W W
7 5
3 3
