15 15
W W W W W W W W W W W W W W W
W G G G G G G G G G W G G G W
W G G G G S Q Q Q G W G G G W
W W W W W S Q Q Q G W G G G W
W G G G G S Q Q G G W G G G W
W G G G G S Q Q W W W G G G W
W G G G G S Q Q G S S G G G W
W W W W W S Q Q Q S S G G G W
W G G G G S Q Q G S S G G G W
W G G G G S Q Q W W W G G G W
W G G G G S Q Q G G W G G G W
W W W W W S Q Q Q G W G G G W
W G G G G S Q Q Q G W G G G W
W G G G G G G G G G W G G G W
W W W W W W W W W W W W W W W
7 5
down

