15 15
W W W W W W W W W W W W W W W
W G G G G G S Q Q Q W G G G W
W G G G G G S Q Q Q W G G G W
W W W W W G S Q Q Q W G G G W
W G G G G G S Q Q Q W G G G W
W G G G G G S Q W W W G G G W
W G G G G G S Q Q S S G G G W
W W W W W G S Q Q S S G G G W
W G G G G G S Q Q S S G G G W
W G G G G G S Q W W W G G G W
W G G G G G S Q Q Q W G G G W
W W W W W G S Q Q Q W G G G W
W G G G G G S Q Q Q W G G G W
W G G G G G S Q Q Q W G G G W
W W W W W W W W W W W W W W W
7 5


