5 5
W W W W W
W G G G W
W G W W W
W G G G W
W W W W W
4 4
1
1 1
