15 15
W W W W W W W W W W W W W W W
W Q Q Q Q S S G G G W G G G W
W Q Q Q S S G G G G W G G G W
W Q Q S S G G G G G W G G G W
W Q S S G G G G G G W W G G W
W S S G G G G G G G G G G G W
W S G G G G G G G G G G G G W
W G G G G G G G G G G G G G W
W G G W W W W W S G G G G G W
W G G G W Q Q Q S G G G G G W
W G G G W Q Q S S G W W G G W
W G G G W Q S S G G W G G G W
W G G G W S S G G G W G G G W
W G G G W S G G G G W G G G W
W W W W W W W W W W W W W W W
7 7
